0000000000000000000000000000000000000000000000000000000000000000000000000000000000000000000000000000000000000000000000000000000000000000000000000000000000000000000000000000000000000000000000000000000000000000000000000000000000000000000000000000000000000
0000000000000000000000000000000000000000000000000000000000000000000000000000000000000000000000000000000000000000000000000000000000000000000000000000000000000000000000000000000000000000000000000000000000000000000000000000000000000000000000000000000000000
0000000000000000000000000000000000000000000000000000000000000000000000000000000000000000000000000000000000000000000000000000000000000000000000000000000000000000000000000000000000000000000000000000000000000000000000000000000000000000000000000000000000000
0000000000000000000000000000000000000000000000000000000000000000000000000000000000000000000000000000000000000000000000000000000000000000000000000000000000000000000000000000000000000000000000000000000000000000000000000000000000000000000000000000000000000
0000000000000000000000000000000000000000000000000000000000000000000000000000000000000000000000000000000000000000000000000000000000000000000000000000000000000000000000000000000000000000000000000000000000000000000000000000000000000000000000000000000000000
0000000000000000000000000000000000000000000000000000000000000000000000000000000000000000000000000000000000000000000000000000000000000000000000000000000000000000000000000000000000000000000000000000000000000000000000000000000000000000000000000000000000000
0000000d00000000000000000000000000000000000000000000000000000000000000000000000000000000000000000000000000000000000000000000000000000000000000000000000000000000000000000000000000000000000000000000000000000000000000000000000000000000000000000000000000000
0000000000000000000000000000000000000000000000000000000000000000000000000000000000000000000000000000000000000000000000000000000000000000000000000000000000000000000000000000000000000000000000000000000000000000000000000000000000000000000000000000000000000
0000000000000000000000000000000000000000000000000000000000000000000000000000000000000000000000000000000000000000000000000000000000000000000000000000000000000000000000000000000000000000000000000000000000000000000000000000000000000000000000000000000000000
0000000000000000000000000000000000000000000000000000000000000000000000000000000000000000000000000000000000000000000000000000000000000000000000000000000000000000000000000000000000000000000000000000000000000000000000000000000000000000000000000000000000000
0000000000000000000000000000000000000000000000000000000000000000000000000000000000000000000000000000000000000000000000000000000000000000000000000000000000000000000000000000000000000000000000000000000000000000000000000000000000000000000000000000000000000
0000000000000000000000000000022222220000000000000000000020000000000000220000000000000000000000000000000000000000000000000000000000000000000000000000000000000000000000000000000000000000000000000000000000000000000000000000000000000000000000000000000000000
0000000000000000000000000000022222220000000000000000022222200000000000200000000000000000000000000000000000000000000000000000000000000000000000000000000000000000000000000000000000000000000000000000000000000000000000000000000000000000000000000000000000000
0000000000000000000000000000000000000000000000000000222000220000000002200000000000000000000000000000000000000000000000000000000000000000000000000000000000000000000000000000000000000000000000000000000000000000000000000000000000000000000000000000000000000
00000000000000000000000000000000000000000000000000222000000220000000220000000000000000000000000000000000000000000000000000000000000000000000m0000000000000000000000000000000000000000000000000000000000000000000000000000000000000000000000000000000000000000
0000000000000000000000000000000000000000000000002220000000002200022220000000000000000000000000000000000000000000000000000000000000000000000000000000000000000000000000000000000000000000000000000000000000000000000000000000000000000000000000000000000000000
00000000000000000000000000000000000000000000000000000000000002222220000000m0000000000000000000000000000000000000000000000000000000000000000000000000000000000000000000000000000000000000000000000000000000000000000000000000000000000000000000000000000000000
0000000000000200000000000000000000000000000000000000000000000000000000000000000000000000000000000000000000000000000000000000000220000000444444440000000000000000000000000000000000000000000000000000000000000000000000000000000000000000000000000000000000000
0000000000000400000000000000000000000000000000000000000000000000000000000000000000000000000000000000000000000000000000000000000000000000000000000000000000000000000000000000000000000000000000000000000000000000000000000000000000000000000000000000000000000
0000000000000000000000000000000000000000000000000000000000000000000000000000000044420000000000000002000000000000000000000000000004444440000000000000000000000000000000000000000000000000000000000000000000000000000000000000000000000000000000000000000000000
0000000000000000000000000000000000000000000000000000000000000000000000044444400000000000000000000004000000000000000000000000000000000000000044400000000000000000000000000000000000000000000000000000000000000000000000000000000000000000000000000000000000000
000000020004242400000000000000m00m000000000000000000000000000000000000000000000000000000020000000000000000000000000000000000003000000000000042400000000000000000000000000000000000000000000000000000000000000000000000000000000000000000000000000000000000000
00000000000000000m000000000000000000000000000000200000220000000000000000000000000004000044000002040204020000m000000m000000000330000000000000424000000000000000000000m00000004440000000m0000000000000000000000000000000000000000000000000000000000000000000000
0000000000000000000000000001000000001000000000004000000000000000000424000000000000000000000000000000000000000000000000000000333000000000000044444400000000000000000000000004222400000000000000000m044444000m004444000m000000000000000000000000000000000000000
0000000000000000000000100001000000001000100000000000000000000000000000000000000000000000000000000000000000000000000000000003333000000000000000000003333333333330000000000042222240000000000300300000000000000000000000000000000000000000000000000000000000000
0000000000000000000000100001000000001000100000000000000000000000000000000000000000000000000000000000000003000000000000300033333000000000000000000000000000000000000000000422222224000000003300330000000000000000000000003000000f00000000000000000000000000000
3333333333333333333333333333333333333333333333333333330033333333333333300003333333333333333333333333333333333333333333333333333000000000000000000000000000000000033333333333333333333333333300333333333333333333333333333333333333333333333333333333333333333
3333333333333333333333333333333333333333333333333333330033333333333333300003333333333333333333333333333333333333333333333333333000000000000000000000000000000000033333333333333333333333333300333333333333333333333333333333333333333333333333333333333333333
3333333333333333333333333333333333333333333333333333330033333333333333300003333333333333333333333333333333333333333333333333333000000000000000000000000000000000033333333333333333333333333300333333333333333333333333333333333333333333333333333333333333333
