00000000000000000000000000000000000000000000000000000000000000000000000000000000000000000000000000000000000000000000000000000000000
00000000000000000000000000000000000000000000000000000000000000000000000000000000000000000000000000000000000000000000000000000000000
00000000000000000000000000000000000000000000000000000000000000000000000000000000000000000000000000000000000000000000000000000000000
00000000000000000000000000000000000000000000000000000000000000000000000000000000000000000000000000000000000000000000000000000000000
00000000000000000000000000000000000000000000000000000000000000000000000000000000000000000000000000000000000000000000000000000000000
00000000000000000000000000000000000000000000000000000000000000000000000000000000000000000000000000000000000000000000000000000000000
0000d000000000000000000000000000000000000000000000000000000000000000000000000000000000000000000000000000000000000000000000000000000
0000000000000000m000000000000000000000000000000000000000000000000000000000000000000000000000000000000000000000000000000000000000000
00000000000000000000000000000000000000000000000000000000000000000000000000000000000000444400004444444400000000000000000000000000000
00000000000000000000000000000000000000000000000002200000000000000000000000000000000000000000000000000000000000000000000000000000000
00000000000000444440000000000000000000000000000004400000000000000000000000000000000000000000000000000000004444400000000000000000000
00000000000004422244000000000000000000000000000000000000000000000000000000004444444000000000000000000000000000000000000000000000000
000000000000442222244000000000000000000000000000000000000000000000000000m0000000000000000000000002222000000000000000000000000000000
000000000004422222224400000000000000000m000000000000000000300000000000000000000000000000000m00000222200000m000000000000000000000000
00000000004422222222244000000000m0000000000000m004400000033000000000000000000000000000000000000000000000000000010000000000000000000
000000000442222222222244000000000022222222222200000000003330000000000200000000000000000010000000000000000000000100000000000f0000000
333333333333333333333333333000033333333333333333000033333330000003333333333333333333333333333333333333333333333333333333333333333333